#####
#...#
#. .#####
#...#...#
#.......#
##o######