#####
#...#
#.#.#
#...#
##.##
##o##