#####
#...#
#. .#
#...#
#...#
##o##