##o####
#.....#
#.....#
#.....#
#---###
#---#
#---#
#####