########
#---...#
#---...o
#---...#
####...#
   #...#
   #####