###########
#---------#
#---------#
#---------#
#######---#
      #---#
      #---#
      #---#
      ##o##