########
#---...#
#---...#
#---...o
########