############
############
#-----..####
#-----..####
#-----..#..#
#vv###..#..#
#..........#
#....    ..#
#....    ..#
#..........#
####o#######